START
2	2	2	2	2	2	2	2	2	2	2	2
2	3	3	3	1	10	1	1	5	1	8	2
2	3	3	3	2	2	2	1	9	1	2	2
2	2	2	2	2	2	2	1	1	1	2	2
2	2	2	2	2	2	2	2	2	2	2	2
END

START
0	0	0	0	0	0	0	0	0	0	0	0
0	4	1	1	5	5	5	5	5	5	0	0
0	2	2	2	0	0	0	5	0	5	0	0
0	0	0	0	0	0	0	5	5	5	0	0
0	0	0	0	0	0	0	0	0	0	0	0
END