START
2	2	2	2	2	2
2	8	3	10	8	2
2	2	2	2	2	2
END

START
0	0	0	0	0	0
0	0	1	5	0	0
0	0	0	0	0	0
END