START
2	2	2	2	2	2	2
2	8	1	1	5	5	2
2	2	2	2	2	1	2
2	1	2	2	2	10	2
2	1	9	9	9	1	2
2	1	3	3	3	1	2
2	2	9	9	9	2	2
2	2	2	2	2	2	2
END

START
0	0	0	0	0	0	0
0	0	1	1	5	5	0
0	5	0	0	0	5	0
0	0	0	0	0	5	0
0	5	0	0	0	5	0
0	5	1	1	1	5	0
0	5	0	0	0	5	0
0	0	0	0	0	0	0
END