START
2	2	2	2	2	2	2	2
2	10  1	1	9	1	1	2
2	1	1	3	1	3	1	2
2	1	3	1	3	1	3	2
2	1	1	3	1	3	1	2
2	3	1	3	1	3	1	2
2	1	3	1	3	1	1	2
2	9	1	1	1	3	8	2
2	2	2	2	2	2	2	2
END

START
0	0	0	0	0	0	0	0
0	5	5	5	0	5	0	0
0	5	5	2	5	4	5	0
0	5	1	5	2	5	4	0
0	5	5	2	5	4	5	0
0	4	5	2	5	4	5	0
0	5	4	5	2	5	5	0
0	0	5	0	5	2	0	0
0	0	0	0	0	0	0	0
END