START
2	2	2	2	2	2	2	2
2	10  9	1	3	2	8	2
2	1	3	5	3	2	1	2
2	1	9	5	1	2	1	2
2	1	9	9	5	2	1	2
2	1	1	1	9	5	1	2
2	1	9	1	9	5	1	2
2	3	9	1	1	1	1	2
2	3	9	1	9	1	1	2
2	2	2	2	2	2	2	2
END

START
0	0	0	0	0	0	0	0
0	5	0	5	4	0	0	0
0	5	2	5	4	0	5	0
0	5	0	5	5	0	5	0
0	5	0	0	5	0	5	0
0	5	5	5	0	5	5	0
0	5	0	5	0	5	5	0
0	4	0	5	5	5	5	0
0	2	0	5	0	5	5	0
0	0	0	0	0	0	0	0
END