START
2	2	2	2	2	2	2	2	2	2	2
2	10  9	1	9	1	9	9	9	1	2
2	1	5	5	9	1	1	1	1	1	2
2	1	9	5	9	1	9	9	9	1	2
2	1	9	5	9	1	9	9	9	1	2
2	1	1	1	9	1	5	5	5	1	2
2	1	9	1	9	1	9	9	9	1	2
2	1	9	1	1	1	5	5	5	1	2
2	1	9	1	9	1	9	9	9	8	2
2	2	2	2	2	2	2	2	2	2	2
END

START
0	0	0	0	0	0	0	0	0	0	0
0	5	0	5	0	5	0	0	0	5	0
0	5	5	5	0	5	5	5	5	5	0
0	5	0	5	0	5	0	0	0	5	0
0	5	0	5	0	5	0	0	0	5	0
0	5	5	5	0	5	5	5	5	5	0
0	5	0	5	0	5	0	0	0	5	0
0	5	0	5	5	5	5	5	5	5	0
0	5	0	5	0	5	0	0	0	5	0
0	0	0	0	0	0	0	0	0	0	0
END
