START
2	2	2	2	2	2	2	2	2
2	1	1	1	3	1	1	8	2
2	1	1	1	3	1	1	1	2
2	10	2	2	2	2	2	2	2
2	1	9	1	1	1	9	1	2
2	1	1	1	9	1	1	7	2
2	2	2	2	2	2	2	2	2
END

START
0	0	0	0	0	0	0	0	0
0	5	5	5	1	5	5	0	0
0	5	5	5	1	5	5	5	0
0	5	0	0	0	0	0	0	0
0	5	0	5	5	5	0	5	0
0	5	5	5	0	5	5	0	0
0	0	0	0	0	0	0	0	0
END
