2	2	2	2	2	2	2	2	2
2	6	1	1	2	1	1	1	2
2	2	2	1	2	2	2	1	2
2	1	1	1	2	1	1	1	2
2	1	2	2	2	1	2	2	2
2	1	1	1	1	1	1	10	2
2	1	2	2	2	1	2	2	2
2	1	1	1	2	1	1	1	2
2	2	2	1	2	2	2	1	2
2	1	1	1	2	8	1	1	2
2	2	2	2	2	2	2	2	2