2	2	2	2	2	2	2	2
2	1	1	1	1	1	1	2
2	1	2	2	2	1	1	2
2	1	6	2	10	1	8	2
2	1	2	2	2	1	1	2
2	1	1	1	1	1	1	2
2	2	2	2	2	2	2	2